NO ./textures/kandinsky-circles.xpm

     SO    ./textures/pavlin.xpm
C 170,188,214



EA        ./textures/space.xpm
WE ./textures/kandinsky-snow.xpm

F         109,151,121

         111
     11111D111111
11111100000011
1111000000001111111
 11100000000000001
11100000000011111111
100111001111111
10010100011
1001110N1111
111111111



