NO ./textures/kandinsky-circles.xpm

     SO    ./textures/pavlin.xpm
C 170,188,214



EA        ./textures/space.xpm
WE ./textures/kandinsky-snow.xpm

F         109,151,121

        1111
    11111D111111
11111D000N011
1111110000001111111
 11D000000000000D1
11110000000011111111
10000001111111
1001D100011
100111001111
111111111



