NO ./textures/kandinsky-circles.xpm

     SO    ./textures/goncharova.xpm
C 56,178,239



EA        ./textures/space.xpm
WE ./textures/kandinsky-snow.xpm

F         0,128,128


111111111111
1000011100011
100000000001
100100000001
100000001111111
100000001111
100000N011
1111111111