NO ./textures/abstract.xpm

     SO    ./textures/fish.xpm
C 56,178,239



EA        ./textures/Christmas-tree.xpm
WE ./textures/robot.xpm

F         63,193,37


111111111111
1000011100011
100000000001
100100000001
100000001111111
100000001111
100000N011

