NO ./textures/kandinsky-circles.xpm

     SO    ./textures/winter.xpm
C 204,255,255



EA        ./textures/space.xpm
WE ./textures/kandinsky-snow.xpm

F         0,128,128

111111111111
111111011111
100001D10001
100000N00001
100100000001
100000001111
100000001111
100000001111
111111111111