

NO ./textures/goncharova.xpm


     SO    ./textures/pavlin.xpm
C 243,200,91




EA        ./textures/space.xpm
WE ./textures/kandinsky-snow.xpm

F         177,162,184


     111111111111
1111111100011
1111110000011111111
 111110010111000001
11111000001 11111111
10011100111 111
1001 100011
100111001111
111111111
