NO ./textures/kandinsky-circles.xpm

     SO    ./textures/pavlin.xpm
C 204,255,255



EA        ./textures/space.xpm
WE ./textures/kandinsky-snow.xpm

F         0,128,128

         111      
     11111D111111
1111110000N011
1111000000001111111
 11D000000000000D1
11110000000011111111
10000001111111
1001D100011
100111001111
111111111



