NO ./textures/colorstone.xpm

     SO    ./textures/greystone.xpm
C 56,178,239



EA        ./textures/purplestone.xpm
WE ./textures/eagle.xpm

F         63,193,37


111111111111
1000011100011
100000000001
100100000001
100000001111
100000001111
1000000N1111
111111111
