111111111
100001001
100000011
100100001
111111111
